#France
ANG = "countries/Angevin.txt"
FRX = "countries/Francia.txt"

#Germany
PTH = "countries/Pruthenia.txt"
PMR = "countries/Pomeralia.txt"

#Spain
LUS	= "countries/Lusitania.txt"
#ATU = "countries/Asturias.txt"
CTA = "countries/Cartagena.txt"
TOL = "countries/Toledo.txt"
IBE = "countries/Iberia.txt"
GDS = "countries/Gades.txt"
GRO = "countries/Spania.txt"

#Italy
MGC = "countries/MagnaGraecia.txt"
TNK = "countries/Trinakria.txt"
KLV = "countries/Kalavria.txt"
PLA = "countries/Apoulia.txt"
NEA = "countries/Neapolis.txt"
ANC = "countries/Ancona.txt"
RMG = "countries/Romagna.txt"

#Russia
GCH = "countries/Galich.txt"
MRM = "countries/Murom.txt"
MTY = "countries/Malatya.txt"
BOL = "countries/Bolgharia.txt"
KHZ = "countries/Khazaria.txt"
WHH = "countries/WhiteHorde.txt"
BLH = "countries/BlueHorde.txt"

#Arabia
CAF = "countries/Caliphate.txt"
ISR = "countries/Israel.txt"
JLR = "countries/Jalayirid.txt"
ASR = "countries/Assyria.txt"
MEA	= "countries/Majal Eali.txt"
QUR	= "countries/Qurais.txt"
GHA	= "countries/Al-Ghasasinah.txt"
BGH	= "countries/Banu Ghatafan.txt"
BTA	= "countries/Banu Tamim.txt"
KIN	= "countries/Kindah.txt"

#Asia Minor
IKO = "countries/Ikonion.txt"
NIC = "countries/Nicaea.txt"
NHR	= "countries/Nahraya.txt"
PLS = "countries/Palestine.txt"

#Maghreb
CTH = "countries/Carthage.txt"
CTG = "countries/Carthago.txt"
MAU = "countries/Mauritania.txt"
NMD = "countries/Numidia.txt"
KYR = "countries/Kyrenaike.txt"
AGD = "countries/Agadir.txt"
TEM = countries/KnightsTemplar.txt
OUT = "countries/Outremer.txt"
GAR = "countries/Garamantia.txt"

#Persia
KRT = "countries/Kartids.txt"
SGD = "countries/Sogdiana.txt"
KRZ = "countries/Khwarezmia.txt"
BKT = "countries/Baktria.txt"
SAM	= "countries/Samarkand.txt"
ZNB	= "countries/Zunbils.txt"
SHH	= "countries/Shahis.txt"

#Africa
KAP = "countries/SouthAfrica.txt"

#East Africa
MRO = "countries/Meroe.txt"
AXU = "countries/Axum.txt"

#Southeast Asia
SRI = "countries/Srivijaya.txt"

#Colonial America
CSA = "countries/CSA.txt"

#India
CAA = "countries/Satara.txt"
CHB = "countries/Chola.txt"
GOA = "countries/Goa.txt"
KNP = "countries/Rayalaseema.txt"
KOD = "countries/Illichpur.txt"
PLD = "countries/Pala.txt"
RMI = "countries/Karnata.txt"
TAM = "countries/Tamilakam.txt"
YMG = "countries/Lahore.txt"

#China
CLI = "countries/Liao.txt"
MGL = "countries/Moghulistan.txt"